anosmic : odourless, no smell at all : General words for smell
antiseptic : clean or pure smell that is bland an characterless : General words for smell
aroma : a smell that is strong but pleasant : General words for smell
comforting : pleasant aroma : General words for smell
delicate : subtle, faint, smell that is not overpowering : General words for smell
evocative : a smell that makes you think of something, often something that you experienced in the past : General words for smell
faint : a smell that is not strong : General words for smell
fragrance : a sweet or pleasant odour : General words for smell
heady : strongly aromatic, pungent, rich, intoxicating, spicy, piquant, not a mild smell : General words for smell
heavy : a sweet and strong smell : General words for smell
intoxicating : A smell that exhilarates, disorients, or excites : General words for smell
laden : a literary word that describes a strong smell : General words for smell
odour/odor : a smell : General words for smell
odorous : a strong smell : General words for smell
odourless : with no smell : General words for smell
piquant : stinging, pungent, an aroma that tickles the nose. : General words for smell
powerful :  a strong smell : General words for smell
redolent : smelling of something : General words for smell
reek : to smell strongly and unpleasantly : General words for smell
scent : a particular smell, especially a pleasant one : General words for smell
whiff : a slight smell of something : General words for smell
acrid : a smell that is strong, bitter, and unpleasant in your nose and throat : Unpleasant Smells
damp : a wet smell : Unpleasant Smells
fetid : an unpleasant smell, usually caused by decay : Unpleasant Smells
frowsty : an unpleasant smell caused by a lack of fresh air : Unpleasant Smells
funky : a strong and unpleasant smell : Unpleasant Smells
fusty : smells old, dusty, or damp : Unpleasant Smells
high : an old-fashioned word that describes a strong flavour and smell : Unpleasant Smells
malodorous : scented, aromatic, redolent, fragrant, stinking. : Unpleasant Smells
musty : unpleasant, stale, and not fresh : Unpleasant Smells
nasty : unpleasant smell : Unpleasant Smells
nauseating : a smell that causes disgust, loathing, or revulsion : Unpleasant Smells
noisome : extremely unpleasant, especially because of being very dirty or having a bad smell : Unpleasant Smells
overpowering  : very strong smell : Unpleasant Smells
pungent : a smell that is strong and sharp : Unpleasant Smells
putrid : decaying and smelling very bad : Unpleasant Smells
rancid : rancid food is no longer fresh and has an unpleasant smell : Unpleasant Smells
rank : a strong unpleasant smell or taste : Unpleasant Smells
ripe : a strong or unpleasant smell : Unpleasant Smells
sickly : makes you feel sick : Unpleasant Smells
smelly : an unpleasant smell : Unpleasant Smells
sour : a taste or smell that is no longer fresh : Unpleasant Smells
stale : not fresh or pleasant : Unpleasant Smells
stench  : a very bad smell, especially of decay : Unpleasant Smells
stinking : an unpleasant smell : Unpleasant Smells
stuffy : a smell caused by an area with no fresh air in it : Unpleasant Smells
ambrosial : sweet smelling, fragrant, aromatic : Pleasant Smells
aromatic : perfumed, fragrant, scented, sweet smelling, pungent, usually pleasing : Pleasant Smells
bouquet : the particular smell of a wine or flower : Pleasant Smells
delicious : a pleasant smell : Pleasant Smells
fresh : a pleasant, newly made smell that can be clean, clear, cool, crisp, refreshing, sweet, warm : Pleasant Smells
fragrant : with a pleasant smell : Pleasant Smells
perfumed : pleasant to smell because perfume has been added or used, or it has a natural perfume : Pleasant Smells
rich : a smell that is strong in a pleasant way : General words for smell
savoury/savory : (US Spelling),pleasant to  taste, spicy, pungent, flavoursome, and aromatic, salty but not sweet : Pleasant Smells
scented : a pleasant smell : Pleasant Smells
sweet  : a pleasant smell that is sweet : Pleasant Smells
tangy : a smell or taste that is strong and bitter in a pleasant way : Pleasant Smells
citrusy : characteristic of citrus fruit in scent : Words that smell like something
coppery : smelling of copper : Words that smell like something
earthy : smelling like earth : Words that smell like something
fishy : smelling like fish : Words that smell like something
floral : smelling of flowers : Words that smell like something
flowery : a flowery smell reminds you of flowers : Words that smell like something
fruity : smelling like fruit : Words that smell like something
gamy : having the distinctive fragrance of game : Words that smell like something
garlicky : smelling of garlic : Words that smell like something
leathery : smells like leather : Words that smell like something
lemony : smells like lemon : Words that smell like something
medicinal : smells like medicine : Words that smell like something
minty : smelling of mint : Words that smell like something
musky : similar to musk in smell : Words that smell like something
peachy : similar to a peach in colour, taste, or smell : Words that smell like something
smoky : smelling of smoke : Words that smell like something
woody : an earthy smell, smelling of wood : Words that smell like something
