Abrasive : a substance that abrades or wears down :  Surfaces, Textures : Adjective,Noun : abrasive_material,abradant,abrasive,scratchy,harsh
Ample : more than enough in size or scope or capacity :  Size : Adjective : ample,plenteous,sizable,copious,sizeable,plentiful,rich
Angular : measured by an angle or by the rate of change of an angle :  General words for touch : Adjective : angulate,angular
Bald : grow bald; lose hair on one's head :  Human : Verb,Adjective : denudate,bald-headed,denuded,barefaced,bald,bald-pated
Barbed : provide with barbs :  Surfaces, Textures : Adjective : mordacious,briary,setaceous,biting,prickly,barb,pungent,barbed,nipping,barbellate,bristled,bristly,burry,thorny,spiny,burred,setose,briery
Bendable : capable of being bent or flexed or twisted without breaking :  General words for touch  : Adjective : bendable,pliable,waxy,pliant
Blemished : mar or spoil the appearance of :  General words for touch : Adjective : flawed,deface,disfigure,blemish,blemished,flaw,spot
Blistered : get blistered :  Surfaces, Textures :  : blister,vesicate,scald,whip
Bloated : become bloated or swollen or puff up :  Sensations, Size :  : bloat
Blunt : make less intense :  Sensations : Verb,Adjective : forthright,blunt,free-spoken,point-blank,deaden,plainspoken,numb,stark,frank,benumb,crude,outspoken,straight-from-the-shoulder,dull,candid
Bristly : very irritable :  Sensations : Adjective : waspish,briary,setaceous,splenetic,prickly,barbed,barbellate,bristly,bristled,burry,thorny,spiny,burred,setose,briery
Broken : terminate :  General words for touch : Adjective : intermit,get_out,break_in,weaken,transgress,busted,fracture,erupt,stop,get_around,upset,humbled,give,wear,offend,split_up,fall_apart,break_out,breach,go_against,disclose,go_bad,bring_out,ruin,part,low,give_out,wiped_out,crack,break_away,break_off,bust,infract,let_out,conk_out,demote,broken,kick_downstairs,confused,give_way,break_down,founder,wear_out,disordered,interrupt,better,die,divulge,bump,violate,let_on,broken_in,give_away,discontinue,smash,crushed,fail,bankrupt,recrudesce,dampen,discover,humiliated,snap_off,separate,fall_in,break-dance,unwrap,check,collapse,impoverished,break_up,pause,develop,relegate,reveal,unkept,break,split,burst,damp,come_apart,soften,expose,go,cave_in,break_dance,rugged
Bubbly : a white sparkling wine either produced in Champagne or resembling that produced there :  General words for touch : Adjective : frothy,foaming,spumy,bubbly,bubbling,foamy,champagne,effervescing
Bulging : swell or protrude outwards :  Size :  : bulge,start,bulgy,pouch,bug_out,bellying,pop,bulk,convex,bulbous,bellied,protrude,bag,bulging,protuberant,bulge_out,pop_out,come_out
Bulky : of large size for its weight :  Size : Adjective : bulky
Bumpy : causing or characterized by jolts and irregular movements :  Surfaces, Textures : Adjective : jolting,jumpy,rough,rocky,jolty,bumpy
Bushy : used of hair; thick and poorly groomed :  General words for touch : Adjective : shaggy,shaggy-haired,bushy,shaggy-coated
Caked : form a coat over :  Sensations :  : coat,cake
Carved : form by carving :  Surfaces, Textures : Adjective : carven,cut_up,chip_at,carve,carved
Chafing : soreness or irritation of the skin caused by friction :  General words for touch : Noun : chafing,nark,irritate,get_to,vex,devil,rub,gravel,annoy,fray,gall,chafe,get_at,rag,bother,rile,excoriate,scratch,nettle,fret
Chapped : crack due to dehydration :  Surfaces, Textures : Adjective : chap,chapped,roughened,cracked
Chunky : like or containing small sticky lumps :  Size : Adjective : low-set,chunky,squat,dumpy,stumpy,lumpy,squatty
Circular : an advertisement (usually printed on a page or in a leaflet) intended for wide distribution :  Shape : Adjective,Noun : orbitual,flyer,broadsheet,handbill,circular,flier,bill,rotary,throwaway,round,broadside
Clammy : unpleasantly cool and humid :  Human,Sensations : Adjective : clammy,dank
Clean : a weightlift in which the barbell is lifted to shoulder height and then jerked overhead :  General words for touch : Adverb,Verb,Adjective : houseclean,fresh,uninfected,blank,fair,strip,clean-living,white,unobjectionable,make_clean,scavenge,clean,plum,clean_house,cleanse,clear,unclouded,neat,clean_and_jerk,uncontaminating,sporty,fairly,plumb,pick,sportsmanlike,sporting,light
Coarse : of textures that are rough to the touch or substances consisting of relatively large particles :  Surfaces, Textures : Adjective : uncouth,rough-cut,common,coarse,harsh,vulgar
Cold : a mild viral infection involving the nose and respiratory passages (but not the lungs) :   Temperature : Adjective,Noun : frigidness,insensate,coldness,frigidity,common_cold,dusty,moth-eaten,frigid,low_temperature,inhuman,stale,cold,cold-blooded
Cool : the quality of being at a refreshingly low temperature :  Temperature : Verb,Adjective,Noun : cool,assuredness,chill,cool_down,poise,coolheaded,cool_off,aplomb,sang-froid,nerveless
Corrugated : fold into ridges :  General words for touch : Adjective : corrugated,corrugate
Cratered :  :  Surfaces, Textures :  : 
Crenelated : supply with battlements :  General words for touch :  : crenellate,crenelate,crenel
Crocheted : create by looping or crocheting :  General words for touch :  : crochet,hook
Cushioned : protect from impact :  Sensations : Adjective : soften,padded,cushion,buffer,cushiony,cushioned
Damaged : inflict damage upon :  General words for touch : Adjective : damaged,discredited,damage
Damp : a slight wetness :  Temperature : Verb,Adjective,Noun : dampen,soften,dampness,mute,moistness,deaden,break,dampish,moist,muffle,tone_down,dull,damp,weaken
Dehydrated : preserve by removing all water and liquids from :  General words for touch : Adjective : desiccate,dried,dehydrate,desiccated,dry_up,dehydrated,exsiccate
Dense : permitting little if any light to pass through because of denseness of matter :  General words for touch : Adjective : dumb,dense,impenetrable,obtuse,slow,thick,heavy,dull,dim
Dented : make a depression into :  Surfaces, Textures :  : dent,crumpled,dented,bent,indent
Dirty : make soiled, filthy, or dirty :  General words for touch : Verb,Adjective : unsportsmanlike,colly,lousy,grime,pestiferous,muddied,filthy,soil,begrime,foul,contaminating,cheating,unsporting,bemire,marked-up,muddy,dingy,ill-gotten,unclean,dirty,soiled,sordid
Distended : become wider :  General words for touch :  : distend,dilate
Distorted : make false by mutilation or addition; as of a message or story :  General words for touch : Adjective : wring,colour,twist,tinge,distort,misrepresented,warp,contort,twisted,twine,strain,ill-shapen,falsify,color,perverted,distorted,deform,garble,malformed,deformed,misshapen
Doughy : having the consistency of dough because of insufficient leavening or improper cooking :  Sensations,Materials : Adjective : soggy,doughy
Downy : like down or as soft as down :  Sensations : Adjective : downy,sericeous,flossy,pubescent,puberulent,fluffy,downlike
Drenched : drench or submerge or be drenched or submerged :  Sensations : Adjective : imbrue,soak,drenched,sop,swamp,drenched_in,souse,douse,dowse,drench
Dry : a reformer who opposes the use of intoxicating beverages :  General words for touch : Verb,Adjective,Noun : dry_out,ironical,wry,dry,prohibitionist,juiceless,teetotal,ironic
Dusty : covered with a layer of dust :  General words for touch : Adjective : dusty,moth-eaten,stale,dust-covered,cold
Embossed : raise in a relief :  General words for touch :  : emboss,embossed,raised,brocaded,stamp,boss
Enamelled : coat, inlay, or surface with enamel :  Materials, Textures :  : enamel
Encrusted : cover or coat with a crust :  Surfaces, Textures :  : crusty,beset,crustlike,incrust,encrusted,crusted,encrust
Engorged : overeat or eat immodestly; make a pig of oneself :  Sensations, Human :  : gorge,gormandize,gourmandize,stuff,overeat,pig_out,overindulge,engorge,englut,glut,congested,gormandise,binge,engorged,scarf_out,overgorge,satiate,ingurgitate
Engraved : carve, cut, or etch into a material or surface :  General words for touch : Adjective : grave,engraved,scratch,etched,engrave,etch,inscribe,incised,inscribed,graven
Etched : make an etching of :  Surfaces, Textures :  : engraved,etched,engrave,etch,incised,inscribed,graven
Even : the latter part of the day (the period of decreasing daylight from late afternoon until nightfall) :  General words for touch : Adverb,Verb,Adjective : still,yet,flush,evening,level,tied,even,eve,regular,fifty-fifty,even_out,eventide
Fat : a soft greasy substance occurring in organic tissue and consisting of a mixture of lipids (mostly triglycerides) :  Size : Adjective,Noun : plump_out,flesh_out,fat,fatten_out,fatty,fertile,productive,plump,fatness,blubber,avoirdupois,adipose_tissue,fatty_tissue,fatten,juicy,fill_out,rich,fatten_up
Feathery : resembling or suggesting a feather or feathers :  General words for touch : Adjective : feathery,featherlike,plumy,feathered
Filmy : so thin as to transmit light :  Sensations :  : gossamer,cobwebby,gauzy,transparent,vaporous,sheer,diaphanous,gauze-like,vapourous,filmy,see-through
Firm : the members of a business organization that owns or operates one or more establishments :  General words for touch : Adverb,Adjective,Noun : firmly,strong,steadfastly,firm,business_firm,unshakable,steadfast,unbendable,unwavering,unwaveringly,truehearted,tauten,immobile,steady,unfaltering,fast,house,solid,loyal,unfluctuating,stiff
Flat : a level tract of land :  Surfaces : Adverb,Adjective,Noun : monotone,unconditional,2-dimensional,directly,insipid,matted,vapid,matte,flat_tire,flatcar,straight,categoric,flat,level,mat,apartment,flavourless,compressed,matt,flavorless,two-dimensional,categorical,savorless,bland,flatbed,savourless,monotonic,monotonous,plane,prostrate
Fleecy : (of fabrics) having soft nap produced by brushing :  Sensations :  : napped,brushed,fleecy
Flimsy : a thin strong lightweight translucent paper used especially for making carbon copies :  Sensations : Adjective : tenuous,thin,slight,unconvincing,flimsy,onionskin,fragile
Fluffy : like down or as soft as down :  Sensations :  : flossy,downlike,fluffy,downy
Fluted : form flutes in :  General words for touch :  : flute
Fragile : easily broken or damaged or destroyed :  General words for touch : Adjective : frail,tenuous,thin,slight,delicate,flimsy,fragile
Freezing : the withdrawal of heat to change something from a liquid to a solid :  Temperature :  : freeze,freeze_down,suspend,freeze_out,immobilize,freezing,block,stop_dead,immobilise
Frigid : sexually unresponsive :  Temperature : Adjective : gelid,polar,arctic,icy,frozen,glacial,frigid,cold,wintry,frosty
Frothy : emitting or filled with bubbles as from carbonation or fermentation :  Sensations :  : frothy,foaming,spumy,scintillating,bubbly,bubbling,effervescent,sparkly,foamy,effervescing
Furry : covered with a dense coat of fine silky hairs :  Sensations :  : furred,furry
Fuzzy : covering with fine light hairs :  General words for touch : Adjective : hazy,blurred,bleary,foggy,fuzzed,muzzy,fuzzy,blurry
Gelatinous : thick like gelatin :  General words for touch : Adjective : gelatinous,gelatinlike,jellylike
Glassy : resembling glass in smoothness and shininess and slickness; ; - Willa Cather :  Sensations : Adjective : vitreous,glazed,vitrified,glassy
Glazed : coat with a glaze :  Sensations : Adjective : glassed,glaze,glaze_over,sugarcoat,shiny,glass_over,glassy,glass,candy,glazed
Glossy : a magazine printed on good quality paper :  Sensations : Adjective,Noun : slick_magazine,calendered,glossy,shiny,lustrous,shining,sheeny,showy,glistening,slick
Glutinous : having the sticky properties of an adhesive :  General words for touch :  : pasty,gluey,gummy,mucilaginous,viscid,glutinous,sticky,viscous
Gnarled : twist into a state of deformity :  General words for touch : Adjective : knotty,mutter,gnarl,croak,gnarled,murmur,knobbed,gnarly,grumble,knotted
Gooey : soft and sticky :  Sensations,Materials : Adjective : gooey,icky
Gossamer : a gauze fabric with an extremely fine texture :  General words for touch : Noun : gossamer,cobwebby,gauzy,transparent,vaporous,cobweb,sheer,gauze-like,diaphanous,ethereal,filmy,vapourous,see-through
Grainy : composed of or covered with particles resembling meal in texture or consistency :  Sensations :  : gritty,grainy,mealy,coarse-grained,granular,granulose,farinaceous
Granular : composed of or covered with particles resembling meal in texture or consistency :  General words for touch :  : gritty,grainy,chondritic,mealy,coarse-grained,granular,granulose,farinaceous
Grating : a barrier that has parallel or crossed bars blocking a passage but admitting air :  General words for touch : Adjective : grating,grate,raspy,rough,gravelly,grind,diffraction_grating,rankle,rasping,scratchy,fret,scrape,eat_into
Gravelly : abounding in small stones :  Sensations : Adjective : grating,raspy,rough,gravelly,pebbly,rasping,scratchy,shingly
Greasy : containing an unusual amount of grease or oil :  Sensations : Adjective : oleaginous,sebaceous,oily,greasy
Grimy : thickly covered with ingrained dirt or soot :  Sensations :  : grimy,grungy,grubby,raunchy,dingy,begrimed
Gritty : composed of or covered with particles resembling meal in texture or consistency :  Sensations :  : gritty,grainy,mettlesome,gamey,spunky,gamy,spirited,mealy,game,coarse-grained,granular,granulose,farinaceous
Grooved : make a groove in, or provide with a groove :  Surfaces, Textures : Adjective : furrow,groove,rut,well-grooved,grooved
Grubby : small sculpin of the coast of New England :  General words for touch : Adjective,Noun : Myxocephalus_aenaeus,grimy,grungy,grubby,raunchy,dingy,begrimed
Hairy : having or covered with hair :  General words for touch, Human : Adjective : haired,hirsute,hairy
Hard : not easy; requiring great physical or mental effort to accomplish or comprehend or endure :  Surfaces : Adverb,Adjective : firmly,strong,knockout,hard,heavily,operose,punishing,backbreaking,heavy,laborious,intemperate,difficult,tough,toilsome,voiceless,surd,grueling,arduous,gruelling,concentrated,unvoiced,severely,severe,intemperately
Harsh : unpleasantly stern :  General words for touch : Adjective : abrasive,rough,harsh,coarse
Hollow : a cavity or space in something :  Sensations : Verb,Adjective,Noun : hollow,dig,hole,empty,excavate,hollow_out,core_out,vacuous,holler
Hot : used of physical heat; having a high or higher than desirable temperature or giving off heat or feeling or causing a sensation of heat or burning :  Temperature : Adjective : live,hot,blistering,red-hot,raging,spicy
Icy : devoid of warmth and cordiality; expressive of unfriendliness or disdain :  Temperature : Adjective : gelid,polar,arctic,icy,frozen,glacial,frigid,wintry,frosty
Impenetrable : not admitting of penetration or passage into or through :  General words for touch : Adjective : impenetrable,heavy,dense
Imprinted : establish or impress firmly in the mind :  Surfaces :  : imprint,impress,form
Indented : set in from the margin :  Surfaces :  : indenture,dent,indent
Inflated : exaggerate or make bigger :  Size :  : balloon,high-sounding,expand,inflate,hyperbolic,high-flown,amplify,inflated,blow_up,billow
Inlaid : decorate the surface of by inserting wood, stone, and metal :  General words for touch : Adjective : inlay,inlaid
Inscribed : carve, cut, or etch into a material or surface :  General words for touch : Adjective : encipher,inscribe,enrol,code,inscribed,write_in_code,enter,cypher,engraved,engrave,autograph,cipher,graven,grave,encrypt,scratch,recruit,etched,enroll,incised
Ironed : press and smooth with a heated iron :  General words for touch : Adjective : iron,ironed,press,iron_out
Irregular : a member of an irregular armed force that fights a stronger force by sabotage and harassment :  Size : Adjective,Noun : maverick,guerrilla,unorthodox,guerilla,second,unpredictable,irregular,temporary,atypical,insurgent
Itchy : nervous and unable to relax :  General words for touch : Adjective : itchy,fretful,fidgety,antsy
Jagged : cut teeth into; make a jagged cutting edge :  General words for touch : Adjective : jaggy,toothed,jag,jagged,notched,scraggy,erose
Knitted : make (textiles) by knitting :  General words for touch : Adjective : crumple,rumple,knit,cockle,pucker,knitted,entwine
Layered : make or form a layer :  General words for touch : Adjective : superimposed,layered,layer
Leathery : resembling or made to resemble leather; tough but pliable :  General words for touch :  : leathery,leathered,coriaceous,leatherlike
Level : a position on a scale of intensity or amount or quality :  General words for touch : Verb,Adjective,Noun : spirit_level,flush,stratum,take_down,tear_down,even_out,unwavering,stage,degree,pull_down,tier,tied,even,floor,horizontal_surface,level_off,rase,flat,level,point,charge,grade,dismantle,storey,raze,story,layer,plane
Limp : the uneven manner of walking that results from an injured leg :  Sensations : Verb,Adjective : gimp,wilted,hobble,hitch,limp
Lined : be in line with; form a line along :  General words for touch : Adjective : seamed,draw,run_along,line,describe,delineate,lined,trace
Long-haired : with long hair :  General words for touch : Adjective : long-haired
Loose : grant freedom to; free from confinement :  General words for touch : Adverb,Adjective : wanton,unleash,liberal,free,liberate,release,let_loose,promiscuous,sluttish,on_the_loose,loose,easy,informal,loosen,unloosen,open,relax,escaped,unaffixed,idle,unloose,slack,at_large,lax,light
Luke-warm :  :  Temperature :  : 
Lumpy : like or containing small sticky lumps :  Sensations : Adjective : lumpy,chunky
Malleable : easily influenced :  General words for touch :  : tractile,pliable,malleable,ductile,tensile,pliant
Metallic : a fabric made of a yarn that is partly or entirely of metal :  Materials : Adjective,Noun : metallic,metal
Moist : slightly wet :  General words for touch :  : dampish,moist,damp
Mosaic : art consisting of a design made of small pieces of colored stone or glass :  Materials : Adjective,Noun : photomosaic,mosaic,arial_mosaic,Mosaic
Mushy : having the consistency of mush :  General words for touch : Adjective : slushy,schmaltzy,drippy,schmalzy,mawkish,bathetic,soppy,mushy,hokey,sentimental,soupy,kitschy,maudlin
Narrow : a narrow strait connecting two bodies of water :  Size : Verb,Adjective,Noun : nail_down,contract,constrict,specialize,specialise,constringe,narrow-minded,narrow,specify,pin_down,peg_down,narrow_down,minute
Neat : clean or organized :  General words for touch : Adjective : swell,full-strength,peachy,corking,groovy,bang-up,orderly,cracking,great,clean,bully,straight,refined,smashing,neat,not_bad,keen,nifty,slap-up,tasteful,dandy
Oily : containing an unusual amount of grease or oil :  Sensations : Adjective : oily,smarmy,oleaginous,soapy,unctuous,buttery,greasy,sebaceous,fulsome
Ornamented : make more attractive by adding ornament, colour, etc. :  Surfaces, Textures :  : ornament,beautify,adorn,grace,embellish,decorate
Padded : add details to :  Surfaces, Textures :  : aggrandise,padded,dramatize,plod,embellish,slog,footslog,cushiony,bolster,aggrandize,blow_up,tramp,trudge,fill_out,dramatise,pad,embroider,lard,cushioned
Patterned : plan or create according to a model or models :  Surfaces, Textures : Adjective : pattern,model,patterned
Pleated : pleat or gather into a ruffle :  Surfaces, Textures :  : plicate,ruffle,pleat
Pliable : susceptible to being led or directed :  Materials, Textures :  : tractile,bendable,flexible,pliable,malleable,waxy,elastic,ductile,fictile,tensile,pliant
Pockmarked : mark with or as if with pockmarks :  Surfaces, Textures :  : pockmark,pocked,pockmarked,potholed
Pointed : indicate a place, direction, person, or thing; either spatially or figuratively :  General words for touch : Adjective : channelize,head,direct,place,signal,orient,betoken,manoeuvre,designate,maneuver,target,bespeak,repoint,channelise,taper,level,point,aim,luff,charge,indicate,pointed,show,steer,manoeuver,sharpen,guide
Pointy :  :  General words for touch :  : 
Polished : make (a surface) shine :  Surfaces : Adjective : shine,fine-tune,milled,smooth,polish_up,refined,brush_up,svelte,round_off,refine,smoothen,polish,polished,urbane,down,dressed,round
Pot-holed :  :  General words for touch :  : 
Prickly : very irritable :  Sensations :  : waspish,briary,setaceous,splenetic,prickly,barbed,barbellate,bristly,bristled,burry,thorny,spiny,burred,setose,briery
Printed : put into print :  General words for touch :  : publish,print,impress
Pulpy : like a pulp or overripe; not having stiffness :  Sensations : Adjective : squashy,pulpy
Ragged : treat cruelly :  General words for touch : Adjective : bait,crucify,cod,rebuke,nark,irritate,get_to,take_to_task,vex,devil,twit,gravel,call_down,lambast,call_on_the_carpet,chide,berate,frustrate,annoy,reprimand,razz,tease,have_words,scold,chafe,get_at,ragged,rag,taunt,bother,dun,tantalize,tantalise,rally,trounce,chew_out,reproof,bedevil,rile,chew_up,torment,nettle,lambaste,ride,remonstrate,jaw,dress_down,bawl_out,lecture
Rasping : uttering in an irritated tone :  General words for touch :  : grating,raspy,rasp,rough,gravelly,rasping,scratchy
Razor-sharp : very clearly delineated :  Surfaces, Textures : Adjective : razor-sharp
Refined : improve or perfect by pruning or polishing :  Surfaces, Textures : Adjective : fine-tune,graceful,elegant,elaborate,refined,rarify,neat,svelte,rectify,refine,processed,tasteful,polish,polished,urbane,down,complicate
Ribbed : form vertical ribs by knitting :  Textures : Adjective : roast,make_fun,ribbed,jest_at,rib,guy,ridicule,laugh_at,costate,poke_fun,blackguard
Ridged : extend in ridges :  Textures : Adjective : keeled,carinate,ridged,ridge,carinated
Rigid : incapable of or resistant to bending :  Surfaces, Textures : Adjective : inflexible,unbending,fixed,rigid,set,strict,stiff
Rough : the part of a golf course bordering the fairway where the grass is not cut short :  Textures : Adjective,Noun : raspy,jumpy,pugnacious,roughly,harsh,rough_out,grating,rocky,rough_in,gravelly,approximate,approximative,rasping,jolty,jolting,uncut,fierce,rough,scratchy,unsmooth,boisterous,crude,bumpy
Rubbery : having an elastic texture resembling rubber in flexibility or toughness :  Textures : Adjective : gristly,rubbery,cartilaginous,rubberlike
Rusty : covered with or consisting of rust :  Materials, Textures : Adjective : rusty,rust-brown,hoary,rust,out_of_practice
Rutted : be in a state of sexual excitement; of male mammals :  Surfaces, Textures : Adjective : furrow,rut,groove,rutted,rutty
Sandy : of hair color; pale yellowish to yellowish brown :  Surfaces, Textures :  : sandy,flaxen,sandlike,arenaceous
Saturated : cause (a chemical compound, vapour, solution, magnetic material) to unite with the greatest possible amount of another substance :  General words for touch : Adjective : saturated,saturate,pure,impregnate,concentrated
Scalding : subject to harsh criticism :  Temperature, Sensations :  : blister,whip,scald
Scarred : mark with a scar :  General words for touch : Adjective : scar,scarred,pock,mark,marred,pit
Scored : gain points in a game :  Surfaces, Textures :  : score,mark,hit,tally,seduce,nock,make,grade,rack_up
Scraped : scratch repeatedly :  Surfaces, Textures :  : scrape_up,grate,scratch_up,altercate,genuflect,scratch,argufy,dispute,quarrel,kowtow,come_up,scrap,trash,skin,scrape,junk
Scratched : cause friction :  Surfaces, Textures :  : rub,come_up,inscribe,cancel,scratch_up,fray,itch,scrape,call_off,excise,chafe,engrave,strike,scrape_up,grave,scratch,expunge,scrub,fret
Sculptured : create by shaping stone or wood or any other hard material :  Surfaces, Textures :  : grave,sculptural,sculpted,modeled,sculpt,sculptured,sculpture,sculpturesque,graven
Serrated : make saw-toothed or jag the edge of :  Surfaces, Textures :  : saw-toothed,toothed,notched,serrated,serrate
Shaggy : used of hair; thick and poorly groomed :  Sensations :  : shaggy,bushy,shagged,shaggy-coated,shaggy-haired
Sharp-edged :  :  General words for touch :  : 
Sheer : turn sharply; change direction abruptly :  Materials, Textures,Sensations : Adverb,Verb : curve,plain,trend,unmixed,transparent,vaporous,downright,slew,out-and-out,diaphanous,slue,perpendicularly,filmy,cobwebby,bluff,unmingled,gossamer,gauzy,rank,swerve,absolute,sheer,veer,cut,bold,gauze-like,vapourous,right-down,see-through
Silky : having a smooth, gleaming surface reflecting light :  Textures :  : silken,silky,silklike,satiny,sleek,slick
Slick : a slippery smoothness :  Surfaces : Verb,Adjective,Noun : slipperiness,pat,slick_down,satiny,sleek,cunning,sleek_down,wily,sly,silken,foxy,glossy,slip,slickness,guileful,silky,slick,tricky,slick_magazine,tricksy,silklike,knavish,glib,dodgy,crafty
Slimy : covered with or resembling slime :  Surfaces, Textures :  : wretched,vile,unworthy,despicable,slimy,slimed,worthless,ugly
Slippery : causing or tending to cause things to slip or slide :  Surfaces, Textures : Adjective : slippery,slippy,tricky
Smooth : the act of smoothing :  Surfaces, Textures : Verb,Adjective,Noun : shine,still,smooth,placid,smooth_out,liquid,fluid,quiet,unruffled,bland,legato,smoothen,politic,fluent,polish,tranquil,suave
Soaked : submerge in a liquid :  Sensations :  : squiffy,plastered,crocked,pissed,dowse,pie-eyed,soaked,inebriate,wet,soused,soak,slopped,tight,imbue,loaded,souse,hit_it_up,gazump,cockeyed,sozzled,hock,hook,sop,surcharge,sloshed,douse,besotted,blind_drunk,fuddled,fleece,plume,pixilated,pluck,pawn,intoxicate,rob,blotto,overcharge,stiff,smashed,drench
Soapy : resembling or having the qualities of soap :  Sensations :  : oily,smarmy,soapy,oleaginous,saponaceous,unctuous,buttery,fulsome
Sodden : wet through and through; thoroughly wet :  Sensations : Adjective : sodden,soppy
Soft : yielding readily to pressure or weight :  Sensations : Adjective : soft,piano,easy,indulgent,balmy,lenient,cushy,flaccid,mild,diffused,sonant,subdued,voiced,gentle,delicate,flabby,easygoing,diffuse
Soggy : (of soil) soft and watery :  General words for touch :  : waterlogged,soggy,sloppy,inert,squashy,miry,sloughy,mucky,swampy,doughy,boggy,muddy,quaggy,torpid,sluggish,marshy
Soiled : make soiled, filthy, or dirty :  General words for touch :  : dirty,colly,soiled,soil,begrime,bemire,grime,unclean
Solid : matter that is solid at room temperature and pressure :  Surfaces, Textures : Adjective,Noun : solid_state,strong,unanimous,substantial,self-colored,solid,upstanding,hearty,satisfying,firm,self-coloured,square,whole,solidness
Sopping : give a conciliatory gift or bribe to :  Sensations :  : sopping,soak,soaking,dripping,sop,souse,douse,dowse,soak_through,drench
Spiky : having or as if having especially high-pitched spots :  General words for touch :  : spiky,peaky
Spiny : having spines :  General words for touch :  : briary,setaceous,prickly,barbed,barbellate,bristled,bristly,burry,thorny,spinous,spiny,burred,setose,briery
Spongy : easily squashed; resembling a sponge in having soft porous texture and compressibility :  General words for touch : Adjective : squashy,spongelike,squishy,spongy
Springy : elastic; rebounds readily :  General words for touch : Adjective : live,bouncy,resilient,springy,lively
Steely : resembling steel as in hardness :  Materials, Textures : Adjective : steely
Stiff : an ordinary man :   Sensations : Adverb,Adjective,Noun : strong,squiffy,plastered,remains,crocked,pissed,firm,unshakable,pie-eyed,steadfast,soaked,unwavering,unbendable,soused,wet,slopped,tight,loaded,starchy,potent,cockeyed,sozzled,steady,rigid,corpse,unfaltering,stiffly,sloshed,besotted,blind_drunk,fuddled,cadaver,buckram,pixilated,blotto,clay,stiff,smashed
Sticky : having the sticky properties of an adhesive :  General words for touch : Adjective : awkward,muggy,steamy,pasty,unenviable,embarrassing,gluey,gummy,mucilaginous,viscid,glutinous,sticky,viscous
Stubbly : having a short growth of beard :  General words for touch :  : stubbly,bestubbled,stubbled
Stuccoed : decorate with stucco work :  General words for touch :  : stucco
Sweaty :  :  Human, Sensations :  : 
Swollen : increase in size, magnitude, number, or intensity :  Size :  : swell_up,puff_up,intumesce,well_up,egotistic,swell,conceited,egotistical,swollen-headed,well,vain,self-conceited,swollen,tumefy,tumesce
Syrupy : overly sweet :  General words for touch : Adjective : honied,cloying,syrupy,treacly,honeyed,saccharine,viscous
Thick : the location of something surrounded by other things :  Size : Adverb,Adjective : chummy,duncical,thick,thickly,stocky,boneheaded,wooden-headed,duncish,slurred,thickset,dense,deep,thick-skulled,compact,midst,blockheaded,buddy-buddy,fatheaded,loggerheaded,heavyset,thickheaded
Thin : lose thickness; become thin or thinner :  Size : Verb,Adjective : slender,reduce,lose_weight,slim,thin,slim_down,lean,tenuous,thinly,cut,fragile,melt_off,slight,dilute,sparse,flimsy,thin_out,slenderize
Thorny : bristling with perplexities :  General words for touch : Adjective : briary,setaceous,prickly,barbed,barbellate,bristled,bristly,thorny,burry,spiny,burred,setose,briery
Throbbing : an instance of rapid strong pulsation (of the heart) :  Human,Sensations : Adjective,Noun : pounding,throbbing,shudder,pulsate,shiver,pulse,throb,thrill
Tiled : cover with tiles :  Materials, Textures : Adjective : tiled,tile
Tough : someone who learned to fight in the streets rather than being formally trained in the sport of boxing :  General words for touch : Adjective : knotty,thug,sturdy,hoodlum,toughie,yobbo,hard,hood,elusive,hooligan,baffling,ruffian,problematical,tough,bully,street_fighter,yob,toughened,strong-armer,roughneck,rowdy,ruffianly,goon,punk,rugged,problematic,yobo,bad
Tweedy : of textiles; having a rough surface :  Materials, Textures : Adjective : slubbed,nubby,nubbly,tweedy,homespun
Unblemished : free from physical or moral spots or stains :  General words for touch : Adjective : unmarred,unblemished,unmutilated
Unbreakable : impossible to break especially under ordinary usage :  General words for touch : Adjective : unbreakable
Uncomfortable : conducive to or feeling mental discomfort :  Human : Adjective : uncomfortable
Uneven : not even or uniform as e.g. in shape or texture :  General words for touch : Adjective : scratchy,uneven,odd,spotty,mismatched
Unyielding : stubbornly unyielding; ; ; ; - T.S.Eliot :  General words for touch : Adjective : tenacious,pertinacious,unyielding,dour,dogged,persistent
Varnished : cover with varnish :  Surfaces, Textures :  : stained,varnished,seal,varnish
Velvety : smooth and soft to sight or hearing or touch or taste :   Sensations, Textures :  : velvety,velvet,velvet-textured
Veneered : cover with veneer :  Surfaces, Textures :  : veneer
Vibrating : shake, quiver, or throb; move back and forth rapidly, usually in an uncontrolled manner :   Sensations :  : vibrate,thrill,tickle,resonate,vacillate,hover,oscillate
Viscous : having a relatively high resistance to flow :  Sensations :  : pasty,syrupy,gluey,gummy,mucilaginous,viscid,glutinous,sticky,viscous
Warm : get warm or warmer :  Temperature : Verb,Adjective : ardent,strong,quick,tender,fond,lovesome,warm_up,warmly,warm,affectionate
Waterlogged : (of soil) soft and watery :  Sensations :  : waterlogged,soggy,sloppy,squashy,miry,sloughy,mucky,swampy,boggy,muddy,quaggy,marshy
Wavy : (of hair) having waves :  General words for touch : Adjective : rippled,crinkly,wavy,wavelike,crinkled
Wet : wetness caused by water :  Sensations : Verb,Adjective : squiffy,plastered,crocked,pissed,pie-eyed,soaked,wet,soused,slopped,tight,moisture,lactating,loaded,cockeyed,sozzled,sloshed,besotted,blind_drunk,fuddled,pixilated,blotto,stiff,smashed
Wide : having great (or a certain) extent from one side to the other :  Size : Adverb,Adjective : spacious,wide-eyed,panoptic,wide-cut,wide_of_the_mark,encompassing,all-encompassing,wide,across-the-board,broad,extensive,blanket,widely,all-embracing,astray,all-inclusive,full
Wiry : lean and sinewy :  General words for touch : Adjective : stringy,wiry
Withered : wither, as with a loss of moisture :  General words for touch :  : shrivelled,sear,dried-up,withered,wizen,wither,fade,shrink,sere,shrivel_up,wizened,shrunken,shrivel,shriveled
Woollen : a fabric made from the hair of sheep :  Materials, Textures :  : woollen,woolen,wool
Woven : interlace by or as if by weaving :  Materials, Textures : Adjective : waver,weave,wander,thread,meander,woven,interweave,wind,tissue
Wrinkled : gather or contract into wrinkles or folds; pucker :  Surfaces, Textures : Adjective : crumple,scrunch_up,furrow,wrinkly,crinkle,crease,unironed,wrinkle,rumple,wrinkled,ruckle,purse,crisp,scrunch
Yielding : a verbal act of admitting defeat :  General words for touch : Adjective : bear,concede,grant,relent,render,afford,succumb,ease_up,give_way,give,cede,move_over,conceding,give_in,yield,buckle_under,soften,surrender,pay,return,concession,knuckle_under,giving_up,generate,yielding
Zigzag : an angular shape characterized by sharp turns in alternating directions :  Surfaces, Textures : Adverb,Verb,Adjective,Noun : zig-zag,zigzag,zag,crank,zig
